#########################
#                       #
#   P                   #
#  ###                  #
#                       #
#                       #
#                       #
#                       #
#                       #
#                       #
#                       #
#                       #
#                       #
#                       #
#                       #
#                       #
#                       #
#           V           E
#########################