##########################
#                        #
#   P                    #
#  ###                   #
#                        #
#                        #
#                        #
#                        #
#                        #
#                        #
#                        #
#                        #
#                        #
#                        #
#                        #
#                        #
#                        #
#                        E
##########################